Variable	Explanation
ID	unique participant ID (6 digits)
SEX	self-reported gender
LANG	language of correspondence
CLINIC	Recruitment clinic
DOB	date of birth
LBP_DURATION	"How long has low back pain been an ongoing problem for you? 1, less than one month | 2, 1-3 months | 3, 3-5 months | 4,  6-11 months | 5, 1-5 years | 6, more than 5 years "
LBP_FREQ	"How often has low back pain pain been an ongoing problem for you over the past 6 months? 1, every day… | 2, at least half the days… | 3, less than half the days…"
LBP_NRS	"In the past 7 days, how would you rate your lower back pain on average? (0-10 scale)"
LBP_RADIATING	"Has low-back pain spread down your leg(s) during the past 2 weeks? 1, Yes | 0, No | 88, Not sure"
PAIN_AB	"During the past 4 weeks, how much have you been bothered by stomach pain? 0, not at all | 1, a little | 2, a lot"
PAIN_LIMB	"During the past 4 weeks, how much have you been bothered by pain in your arms, legs, joints? 0, not at all | 1, a little | 2, a lot"
PAIN_HEAD	"During the past 4 weeks, how much have you been bothered by headaches? 0, not at all | 1, a little | 2, a lot"
PAIN_WIDESPREAD	"During the past 4 weeks, how much have you been bothered by widespread pain? 0, not at all | 1, a little | 2, a lot"
LB_SURGERY_EVER	"Have you ever had a low-back surgery? 1, Yes one surgery | 2, Yes more than one surgery | 0, No"
LB_SURGERY_WHEN	"When was your last low-back surgery? 1, Less than 6 months ago | 2, 6 months or more… | 3, Between 1 and 2 years ago | 4, More than 2 years ago"
LB_SURGERY_ARTHRODESIS	"Did any of your low-back surgeries involve a spinal fusion (also called an arthrodesis)? 1, Yes | 0, No | 88, Not sure"
Q9a	"In the past 7 days, how much did your low-back pain interfere with your day-to-day activities? 1, not at all | 2, a little | 3, somewhat | 4, quite a bit | 5, very much"
Q9b	"In the past 7 days, how much did your low-back pain interfere with work around the home (e.g., garden work, renovations)? 1, not at all | 2, a little | 3, somewhat | 4, quite a bit | 5, very much"
Q9c	"In the past 7 days, how much did your low-back pain interfere with your ability to participate in social activities? 1, not at all | 2, a little | 3, somewhat | 4, quite a bit | 5, very much"
Q9d	"In the past 7 days, how much did your low-back pain interfere with your household chores (e.g., house cleaning, vacuuming)? 1, not at all | 2, a little | 3, somewhat | 4, quite a bit | 5, very much"
SCORE_PROMIS_SF_PI_T	PROMIS Short Form v1.0 - Pain Interference t-score
PROMIS_SF_PI_SE	PROMIS Short Form v1.0 - Pain Interference standard error
OPIOIDS	"Have you used Opioids? 0, no | 1, yes, currently | 2, yes, in past | 88, not sure "
INJECTIONS	"Have you used injections/infilterations? 0, no | 1, yes, currently | 2, yes, in past | 88, not sure "
EXERCISE	"Have you used exercise therapy? 0, no | 1, yes, currently | 2, yes, in past | 88, not sure "
PSYCHO	"Have you used psychological counselling? 0, no | 1, yes, currently | 2, yes, in past | 88, not sure "
OTHER_RX	Have you used any other treatment?
LBP_UNEMPLOYED	"Have you been off work or unemployed for 1 or more months due to lower back pain? 0, no | 1, yes | 77, n/a "
LBP_COMPENSATION	"Have you applied for disability or worker’s compensation benefits because you were unable to work due to low back pain? 0, no | 1, yes | 77, n/a "
Q12a	"Are you able to do chores such as vacuuming or yard work? 1, Without any difficulty | 2, With a little difficulty | 3, With some difficulty | 4, With much difficulty | 5, Unable to do"
Q12b	"Are you able to go up and down stairs at a normal pace? 1, Without any difficulty | 2, With a little difficulty | 3, With some difficulty | 4, With much difficulty | 5, Unable to do"
Q12c	"Are you able to go for a walk of at least 15 minutes? 1, Without any difficulty | 2, With a little difficulty | 3, With some difficulty | 4, With much difficulty | 5, Unable to do"
Q12d	"Are you able to run errands and shop? 1, Without any difficulty | 2, With a little difficulty | 3, With some difficulty | 4, With much difficulty | 5, Unable to do"
SCORE_PROMIS_SF_PF_T	PROMIS Short Form v2.0 - Physical function t-score
PROMIS_SF_PF_SE	PROMIS Short Form v2.0 - Physical function standard error
Q13a	"In the past 7 days, how often did you feel worthless? 1, Never | 2, Rarely | 3, Sometimes | 4, Often | 5, Always"
Q13b	"In the past 7 days, how often did you feel helpless? 1, Never | 2, Rarely | 3, Sometimes | 4, Often | 5, Always"
Q13c	"In the past 7 days, how often did you feel depressed? 1, Never | 2, Rarely | 3, Sometimes | 4, Often | 5, Always"
Q13d	"In the past 7 days, how often did you feel hopeless? 1, Never | 2, Rarely | 3, Sometimes | 4, Often | 5, Always"
SCORE_PROMIS_SF_DD_T	PROMIS Short Form v1.0 - Depression/Distress t-score
PROMIS_SF_DD_SE	PROMIS Short Form v1.0 - Depression/Distress standard error
SLEEP_QUALITY	"In the past 7 days, how was your sleep quality? 1, very poor | 2, poor | 3, fair | 4, good | 5, very good"
Q15a	"In the past 7 days, was your sleep refreshing? 1, Not at all | 2, A little bit | 3, Somewhat | 4, Quite a bit | 5, Very much"
Q15b	"In the past 7 days, did you have a problem with your sleep? 1, Not at all | 2, A little bit | 3, Somewhat | 4, Quite a bit | 5, Very much"
Q15c	"In the past 7 days, did you have difficulty falling asleep? 1, Not at all | 2, A little bit | 3, Somewhat | 4, Quite a bit | 5, Very much"
SCORE_PROMIS_SF_SD_T	PROMIS Short Form v1.0 - Sleep Disturbance t-score
PROMIS_SF_SD_SE	PROMIS Short Form v1.0 - Sleep Disturbance standard error
LBP_SAFE	"It’s not really safe for a person with your lower back pain problem to be physically active: 1, Agree/ 0, disagree"
LBP_TERRIBLE	"You feel that your lower back pain is terrible and it’s never going to get any better: 1, Agree/ 0, disagree"
LBP_LAWSUIT	"Are you involved in a lawsuit or legal claim related to your low-back problem? 1, Yes | 0, No | 88, Not sure"
ALCO_DRUGS_1	"In the past year have you consumed alcohol or used drugs more than you meant to? 1, never | 2, rarely | 3, sometimes | 4, often | 5, always"
ALCO_DRUGS_2	"In the past year have you felt you wanted or needed to cut down on your drinking or drug use? 1, never | 2, rarely | 3, sometimes | 4, often | 5, always"
ABORIGINAL	"Are you an Aboriginal person, that is, First Nations, Métis, or Inuk (Inuit)? 0, No not an aboriginal person | 1, Yes First Nations… | 2, Yes Metis | 3, Yes Inuk"
RACE	"Race/ethnicity: 1, White | 2, South Asian | 3, Chinese | 4, Black | 5, Filipino | 6, Latin American | 7, Arab | 8, Southeast Asian | 9, West Asian |, 10, Korean | 11, Japanese | 12, Other"
EMPLOYMENT	"employment status: 1, Working  full time | 2, Working part-time | 3, Looking for work | 4, Sick or maternity leave | 5, Disabled due to back pain… | 6, Disabled for reasons other… | 7, Student | 8, Temporarily laid off | 9, Retired | 10, Keeping house | 55, Unknown | 11, Other"
EDUCATION	"education level: 1, No high school… | 2, High school | 3, Registered Apprenticeship… | 4, College, CEGEP…| 5, University certificate… below | 6, Bachelor’s degree… | 7, University certificate… above | 8, Master’s degree | 9, Degree in medicine… | 10, Doctorate    "
SMOKING	"smoking status: 0, Never smoked | 1, Current smoker | 2, Used to smoke…"
HEIGHT	Height (cm)
WEIGHT	Weight (kg)
Q1a	"Does your pain have BURNING characteristics? 0, no | 1, yes"
Q1b	"Does your pain have PAINFUL COLD characteristics? 0, no | 1, yes"
Q1c	"Does your pain have ELECTRIC SHOCK characteristics? 0, no | 1, yes"
Q2a	"Is your pain associated with TINGLING? 0, no | 1, yes"
Q2b	"Is your pain associated with PINS AND NEEDLES? 0, no | 1, yes"
Q2c	"Is your pain associated with NUMBNESS? 0, no | 1, yes"
Q2d	"Is your pain associated with ITCHING? 0, no | 1, yes"
SCORE_DN4	DN4 Score
SCORE_SCL90RSSP	SCL-90-R-Somatization subscale with pain Score
SCORE_SCL90RSSWP	SCL-90-R-Somatization subscale without pain Score
SCORE_SCL90R	Total SCL-90-R-Somatization Score
